#########################
#.........#.............#
#.........#.............#
#.........#.............#
#.####....#.............#
#....#....#########.#####
#....#..................#
#....#..................#
#...##.........##.#######
#...#..........#........#
#...#..........#........#
#.##....................#
#.....########.##########
#............#..........#
#######......#..........#
#............#..........#
#.....#...####......#...#
#.....#.................#
#.....#...#.............#
##.####...#...#.....#...#
#.........#.............#
#.....#...#.............#
#.....#...#...#.....#...#
#.....#..##.............#
#########################