#########################
#.......................#
#.......................#
#.......................#
#.......................#
#.......................#
#.......................#
#.......................#
#.................#######
#.......................#
#.......................#
#.......................#
#.......................#
#.......................#
#######.................#
#.......................#
#.....#.................#
#.....#.................#
#.....#.................#
#.......................#
#.......................#
#.......................#
#.......................#
#.......................#
#########################