####################
#..................#
#..................#
#..................#
#..................#
#..................#
#..................#
#..................#
#............#######
#..................#
#..................#
#..................#
#..................#
#..................#
#..................#
#######............#
#..................#
#.....#............#
#.....#............#
####################